%%%%%%%%%%%%%%%%%%%%%
%  %    %     %  GGG%
%     %    %     % G%
%  %    %     %     %
% P   %    %     %  %
%  %    %     %    G%
%     %    %     %  %
%P %    %     %    G%
%%%%%%%%%%%%%%%%%%%%%
% % % % %%%%%%%%%%%%%
%%%%%%%%%%%%%%%%%%%%%
