%%%%%%%%%%%%%%%%%%%%%
%GG%    %     %   GG%
%     %    %     %  %
%  %    %     %     %
%    %    %     %   %
%  %    %     %     %
%     %  P  %    %  %
%  %    %     %     %
%%%%%%%%%%%%%%%%%%%%%
% % % % %%%%%%%%%%%%%
%%%%%%%%%%%%%%%%%%%%%
