%%%%%%%%%%%%%%%%%%%%
%   G           G  %
%                  %
%G%%%%%%%P%%%%%%%% %
%                  %
%   G             P%
%%%%%%%%%%%%%%%%%%%%
% % % % %%%%%%%%%%%%
%%%%%%%%%%%%%%%%%%%%
