%%%%%%%%%%%%%%%%%%%%%
%                   %
%   G%        %G    %
%  %%%        %%%   %
%         P         %
%  %%%         %%%  %
%   G%         %G   %
%                   %
%%%%%%%%%%%%%%%%%%%%%
% % % % %%%%%%%%%%%%%
%%%%%%%%%%%%%%%%%%%%%
